50,35,,,,,,,,,,,,,,,,,,,,,,,,,,,,,,,,,,,,,,,,,,,,,,,,
0,0,0,0,0,0,0,0,0,0,0,0,0,0,0,0,0,0,0,0,0,0,0,0,0,0,0,0,0,0,0,0,0,0,0,0,0,0,0,0,0,0,0,f,f,f,f,f,f,f
0,0,0,0,0,0,0,0,0,0,0,0,0,0,0,0,0,0,0,0,0,0,0,0,0,0,0,0,0,0,0,0,0,0,0,0,0,0,0,0,0,0,0,f,f,f,f,f,f,f
0,0,0,0,0,0,0,0,0,0,0,0,0,0,0,0,0,0,0,0,0,0,0,0,0,0,0,0,0,0,0,0,0,0,0,0,0,0,0,0,0,0,0,f,f,f,f,f,f,f
0,0,0,0,0,0,0,0,0,0,0,0,0,0,0,0,0,0,0,0,0,0,0,0,0,0,0,0,0,0,0,0,0,0,0,0,0,0,0,0,0,0,0,f,f,f,f,f,f,f
0,0,0,0,0,0,0,0,0,0,0,0,0,0,0,0,0,0,0,0,0,0,0,0,0,0,0,0,0,0,0,0,0,0,0,0,0,0,0,0,0,0,0,f,f,f,f,f,f,f
0,0,0,0,0,0,0,0,0,0,0,0,0,0,0,0,0,0,0,0,0,0,0,0,0,0,0,0,0,0,0,0,0,0,0,0,0,0,0,0,0,0,0,f,f,f,f,f,f,f
0,0,0,0,0,0,0,0,0,0,0,0,0,0,0,0,0,0,0,0,0,0,0,0,0,0,0,0,0,0,0,0,0,0,0,0,0,0,0,0,0,0,0,f,f,f,f,f,f,f
0,0,0,0,0,0,0,0,0,0,0,0,0,0,0,0,0,0,0,0,0,0,0,0,0,0,0,0,0,0,0,0,0,0,0,0,0,0,0,0,0,0,0,f,f,f,f,f,f,f
0,0,0,0,0,0,0,0,0,0,0,0,0,0,0,0,0,0,0,0,0,0,0,0,0,0,0,0,0,0,0,0,0,0,0,0,0,0,0,0,0,0,0,f,f,f,f,f,f,f
0,0,0,0,0,0,0,0,0,0,0,0,0,0,0,0,0,0,0,0,c,0,0,/,/,0,0,0,0,0,0,0,0,0,0,0,0,0,0,0,0,0,0,f,f,f,f,f,f,f
0,0,0,0,0,0,0,0,0,0,0,0,0,0,0,0,0,d,0,c,0,0,0,C,/,0,0,0,0,0,c,0,c,0,c,0,0,0,0,0,0,0,0,f,f,f,f,f,f,f
0,0,0,0,0,0,0,0,0,0,0,0,0,0,0,0,0,d,c,0,0,0,d,d,d,d,0,0,0,0,d,d,d,d,d,0,0,0,0,0,0,0,0,f,f,f,f,f,f,f
0,0,0,0,0,0,0,0,0,0,0,0,0,0,0,0,0,d,0,c,0,0,0,0,0,0,0,0,0,0,0,0,0,0,0,0,0,0,0,0,0,0,0,f,f,f,f,f,f,f
0,0,0,0,0,0,0,0,0,0,0,0,0,0,0,0,0,0,0,0,c,0,0,0,0,0,0,0,0,0,0,0,0,0,0,0,0,0,0,0,0,0,0,f,f,f,f,f,f,f
0,0,0,0,0,0,0,0,0,0,0,0,0,0,0,0,0,0,0,0,0,0,0,0,0,0,0,0,0,0,0,0,0,0,0,0,0,0,0,0,0,0,0,f,f,f,f,f,f,f
0,0,0,0,0,0,0,0,0,0,0,0,0,0,0,0,0,0,0,0,0,0,0,0,0,0,0,0,0,0,0,0,0,0,0,0,0,0,0,0,0,0,0,f,f,f,f,f,f,f
0,0,0,0,0,0,0,0,0,0,0,0,0,0,0,0,0,0,0,0,0,0,0,0,0,0,0,0,0,0,0,0,0,0,0,b,0,0,0,0,0,0,0,F,f,f,f,f,f,f
0,0,0,0,0,0,0,0,0,0,0,0,0,0,0,0,0,0,0,0,0,0,0,d,d,d,0,0,0,0,0,0,0,0,d,d,0,0,0,0,0,0,0,w,w,w,w,w,w,w
0,0,0,0,0,0,0,0,0,0,0,0,0,0,0,0,0,0,0,0,0,0,0,0,0,0,0,0,0,0,0,0,0,0,0,0,0,0,0,0,0,0,0,w,w,w,w,w,w,w
0,0,0,0,0,0,0,0,0,0,0,0,0,0,0,0,0,0,0,0,0,0,0,0,0,0,0,0,0,c,b,c,0,0,0,0,0,0,0,0,0,0,0,w,w,w,w,w,w,w
0,0,0,0,0,0,0,0,0,0,0,0,0,0,0,0,0,0,0,0,0,0,0,0,0,0,0,0,0,w,w,w,0,0,0,0,0,0,0,0,0,0,0,w,w,w,w,w,w,w
0,0,0,0,0,0,0,0,0,0,0,0,0,0,0,0,0,0,0,0,0,0,0,0,0,0,0,0,0,0,0,0,0,0,0,0,0,0,0,0,0,0,0,w,w,w,w,w,w,w
0,0,0,0,0,0,0,0,0,0,0,0,0,0,0,0,0,0,c,0,0,0,0,0,0,0,0,0,0,0,0,0,0,0,0,0,0,0,0,0,0,0,0,w,w,w,w,w,w,w
0,0,0,0,0,0,0,0,0,0,0,0,0,0,0,0,0,c,0,0,0,w,w,w,w,w,w,w,w,w,w,w,w,w,w,w,0,0,0,0,0,0,0,w,w,w,w,w,w,w
0,0,0,0,0,0,0,0,0,0,0,0,0,0,0,0,c,0,w,w,w,w,w,w,w,w,w,w,w,w,w,w,w,w,w,w,0,0,0,0,0,0,0,w,w,w,w,w,w,w
0,0,0,0,0,0,0,0,0,0,0,0,0,0,0,0,0,0,0,0,0,0,0,0,0,0,w,w,w,w,w,w,w,w,w,w,w,0,0,0,0,0,0,w,w,w,w,w,w,w
0,0,0,0,0,0,0,0,0,0,b,0,0,0,0,0,0,0,0,0,0,0,0,0,0,0,w,w,w,w,w,w,w,w,w,w,w,0,0,0,0,0,0,w,w,w,w,w,w,w
0,0,0,0,0,0,0,0,w,w,w,w,w,0,0,0,0,0,0,0,0,0,0,0,0,0,w,w,w,w,w,w,w,w,w,w,w,w,w,w,w,w,w,w,w,w,w,w,w,w
0,0,0,0,0,0,0,0,w,w,w,w,w,w,0,0,0,0,0,0,0,0,0,0,0,0,w,w,w,w,w,w,w,w,w,w,w,w,w,w,w,w,w,w,w,w,w,w,w,w
0,0,0,0,0,0,0,0,w,w,w,w,w,w,w,0,0,0,0,0,0,0,0,0,0,0,w,w,w,w,w,w,w,w,w,w,w,w,w,w,w,w,w,w,w,w,w,w,w,w
0,0,0,0,0,0,0,0,w,w,w,w,w,w,w,w,0,0,0,0,0,0,0,0,0,0,w,w,w,w,w,w,w,w,w,w,w,w,w,w,w,w,w,w,w,w,w,w,w,w
0,0,0,0,0,0,0,0,w,w,w,w,w,w,w,w,w,0,0,0,0,0,0,0,0,0,w,w,w,w,w,w,w,w,w,w,w,w,w,w,w,w,w,w,w,w,w,w,w,w
0,0,p,0,0,b,0,0,w,w,w,w,w,w,w,w,w,w,0,0,0,0,0,0,0,0,w,w,w,w,w,w,w,w,w,w,w,w,w,w,w,w,w,w,w,w,w,w,w,w
w,w,w,w,w,w,w,w,w,w,w,w,w,w,w,w,w,w,w,w,w,w,w,w,w,w,w,w,w,w,w,w,w,w,w,w,w,w,w,w,w,w,w,w,w,w,w,w,w,w
w,w,w,w,w,w,w,w,w,w,w,w,w,w,w,w,w,w,w,w,w,w,w,w,w,w,w,w,w,w,w,w,w,w,w,w,w,w,w,w,w,w,w,w,w,w,w,w,w,w
