50,19,,,,,,,,,,,,,,,,,,,,,,,,,,,,,,,,,,,,,,,,,,,,,,,,
0,0,0,0,0,0,0,0,0,0,0,0,0,0,0,0,0,0,0,0,0,0,0,0,0,0,0,0,0,0,0,0,0,0,0,0,0,0,0,0,0,0,f,f,f,f,f,f,f,f
0,0,0,0,0,0,0,0,0,0,0,0,0,0,0,0,0,0,0,0,0,0,0,0,0,0,0,0,0,0,0,0,0,0,0,0,0,0,0,0,0,0,f,f,f,f,f,f,f,f
0,0,0,0,0,0,0,0,0,0,0,0,0,0,0,0,0,0,0,0,0,0,0,0,0,0,0,0,0,0,0,0,0,0,0,0,0,0,0,0,0,0,f,f,f,f,f,f,f,f
0,0,0,0,0,0,0,0,0,0,0,0,0,0,0,0,0,0,0,0,0,0,0,0,0,0,0,0,0,0,0,0,0,0,0,0,0,0,0,0,0,0,f,f,f,f,f,f,f,f
0,0,0,0,0,0,w,c,0,c,0,0,0,0,0,c,0,0,0,0,0,0,0,0,0,0,0,0,0,0,0,0,0,0,0,0,0,0,0,0,0,0,f,f,f,f,f,f,f,f
0,0,0,0,0,0,w,0,/,/,c,0,0,0,0,0,c,0,0,0,0,0,0,0,0,0,0,0,0,0,0,0,0,0,0,0,0,0,0,0,0,0,f,f,f,f,f,f,f,f
0,0,0,0,0,0,w,c,C,/,0,0,0,0,0,0,0,0,0,0,0,0,0,0,0,0,0,0,0,0,0,0,0,0,0,0,0,0,0,0,0,0,f,f,f,f,f,f,f,f
0,0,0,0,0,0,w,0,c,0,c,0,0,0,0,0,0,c,0,0,0,0,0,0,0,0,0,0,0,0,0,0,0,0,0,0,0,0,0,0,0,0,f,f,f,f,f,f,f,f
0,0,0,0,0,0,w,w,w,w,w,0,0,0,0,0,0,d,0,0,0,0,0,0,0,0,0,0,0,0,0,0,0,0,0,0,0,0,0,0,0,0,f,f,f,f,f,f,f,f
0,0,0,0,0,0,0,0,0,0,0,0,0,0,0,0,0,0,0,0,0,c,0,0,0,0,0,0,0,0,0,0,0,0,0,0,c,c,0,0,0,0,f,f,f,f,f,f,f,f
0,0,0,0,0,0,0,0,0,0,0,0,0,0,0,0,0,0,0,0,0,d,0,0,0,0,0,0,0,0,0,0,0,0,0,c,0,0,c,0,0,0,f,f,f,f,f,f,f,f
0,0,0,0,0,0,0,0,0,0,0,0,0,0,0,0,0,0,0,0,0,0,0,0,0,0,d,d,0,0,0,0,0,0,c,0,0,0,0,0,0,0,f,f,f,f,f,w,w,w
0,0,0,0,0,0,0,0,0,0,0,0,0,c,0,0,0,0,0,0,0,0,0,0,0,0,0,0,0,0,0,0,0,0,0,0,0,0,0,0,0,0,F,f,w,w,w,w,w,w
0,0,0,0,0,0,0,0,0,0,0,0,c,0,w,w,0,0,0,0,0,0,0,0,0,0,0,0,0,0,0,w,w,w,0,0,0,0,0,w,w,w,w,w,w,w,w,w,w,w
0,0,0,0,0,d,d,d,0,0,0,0,0,0,w,w,w,0,0,0,0,0,0,w,w,w,w,w,0,0,0,w,w,w,0,0,0,0,0,w,w,w,w,w,w,w,w,w,w,w
0,0,0,0,0,0,0,0,0,0,w,w,0,0,w,w,w,w,0,0,0,0,0,0,0,0,0,0,0,0,0,0,0,0,0,0,0,0,0,w,w,w,w,w,w,w,w,w,w,w
0,0,p,0,0,0,0,0,0,0,w,w,0,0,w,w,w,w,w,0,0,0,0,0,0,0,0,0,0,0,0,0,0,0,0,0,0,0,0,w,w,w,w,w,w,w,w,w,w,w
w,w,w,w,w,w,w,w,w,w,w,w,w,w,w,w,w,w,w,w,w,w,w,w,w,w,w,w,w,w,w,w,w,w,w,w,w,w,w,w,w,w,w,w,w,w,w,w,w,w
w,w,w,w,w,w,w,w,w,w,w,w,w,w,w,w,w,w,w,w,w,w,w,w,w,w,w,w,w,w,w,w,w,w,w,w,w,w,w,w,w,w,w,w,w,w,w,w,w,w
,,,,,,,,,,,,,,,,,,,,,,,,,,,,,,,,,,,,,,,,,,,,,,,,,
,,,,,,,,,,,,,,,,,,,,,,,,,,,,,,,,,,,,,,,,,,,,,,,,,
,,,,,,,,,,,,,,,,,,,,,,,,,,,,,,,,,,,,,,,,,,,,,,,,,
,,,,,,,,,,,,,,,,,,,,,,,,,,,,,,,,,,,,,,,,,,,,,,,,,
,,,,,,,,,,,,,,,,,,,,,,,,,,,,,,,,,,,,,,,,,,,,,,,,,
,,,,,,,,,,,,,,,,,,,,,,,,,,,,,,,,,,,,,,,,,,,,,,,,,
